NO ./textures/wall1.png

SO ./textures/wall2.png

WE ./textures/wall3.png

EA ./textures/wall4.png

F 18446744073709551618,50,40

C 80,0,15

      11111111111111111111111111111111111111111111111111111111111111111111111111
     1110000001111110000000000000000011000111111111000000000000000000000000111011
    110000111000000000111000011101000000100000000000001111111110001110001100000011
   11000111111111111111111111111111111111111111111111111111111111111111111111110011
  110011                                                                      110011
 110011  111111111111     111111111   11    11  111       111   111111111      110011
110011    1          1   1         1  1 1  1 1   1 1     1 1   1         1      110111
110111     11111  11111  1  11111  1  1 1 1 1     1 1   1 1    1  11111  1      110011
110111         1 1       1 1     1 1  1 11 1       1 1 1 1     1 1     1 1      111011
110111         1 1       1 1     1 1  1   1         1 1 1      1 1     1 1      111011
110111         1 1       1 1     1 1  1   1          1 1       1 1     1 1      111011
110011         1 1       1 1     1 1  1 11 1         1 1       1 1     1 1      110011
111011         1 1       1  11111  1  1 1 1 1        1 1       1  11111  1      110111
110011         1 1       1         1  1 1  1 1       1 1       1         1      110011
 110011         11        111111111   11    11        11        111111111      110011
  110011                                                                      110011
   11000111111111111111111111111111111111111111111111111111111111111111111111110011
    111001000000000000000000000000001111110000000001111110100000000000111001110011
     1110001110000000000000110111000000000000111000000000000111011100000000000011
      11111111111111011111111111111111111111111111111111111111111111111111111111
                   101
    111111111111111101111111111111111
  1100000000000000000000000000000000011
11000111111110111111111111111111111100011
11101    1100011                   111011
11101  1100011  111      11111111  111011
110011100011  111      111    111  111011
1101100011  111 111         111  11000011
11000011  111  111       111   1100010011
110111  11111111111   111   1110001110011
110011 1     111    111  1 1100011 110111
11101 1 1   111   11111111100011   110111
111011 1   1            100011     110011
11100111111111111111111111011111111100011
  1100000000000000000000000000000000011
    111111111111111101111111111111111
                   101
               11111011111
               10000000001
               10000000001
               10000000001
               10000000001
               10000N00001
               10000000001
               10000000001
               10000000001
               10000000001
               11111111111