NO ./textures/wall1.png

SO ./textures/wall2.png

WE ./textures/wall3.png

EA ./textures/wall4.png

F 40,40,40

C 180,0,0

111111111111111111111111111111111111111111111111111111111111
100000000000000000000000000000000000000000000000000000000001
100000000000000000000000000000000000000000000000000000000001
100000000000000000001000000000000000000000000000000000000001
100000000000000000000100000000000000000000000000000000000001
100000000000000000000010000000000000000000000000000000010001
100000000000000000000001000000000000000000000000000000100001111111111111111111111111111111111111111111
100000000000000000000000100000000000000000000000000001000000000000000000000000000000000000000000000001
100000000000000000000000010000000000000000000000000010000000000000000000000000000000000000000000000001
100000000000000000000000001000000000000000000000000100000000000000000000000000000000000000000000000001
100000000000000000000000000100000000000000000000001000000001111111111111111111111111111111111111110001
100000000000000000000000000010000000000000000000010000000001                                     10001
100000000000000000000000000001000000000000000000100000000001                                     10001
100000000000000000000000000000100000000000000001000000000001111111111111111111111111111111111111110001
100000000000000000000000000000010000000000000010000000000000000000000000000000000000000000000000000001
100000000000000000000000000000001000000000000100000000000000000000000000000000000000000000000000000001
100000000000000000000000000000000100000000001000000000000000000000000000000000000000000000000000000001
100000000000000000000000000000000010000000010000000000000001111111111111111111111111111111111111111111
100000000000000000000000000000000001000000100000000000000001
100000000000000000000000000000010000100001000000000000000001
100000000000000000000000000000100000000010000000000000000001
10000000000000000000000E000001000000000100000000000000000001
100000000000000000000000000010000000100000000000000000000001
100000000000000000000000000100000000100000000000000000000001
100000000000000000000000111000000000100000000000000000000001
100000000000000000000000000000000000100000000000000000000001111111111111111111111111111111111111111111
100000000000000000000000111111100000100000000000000000000000000000000000000000000000000000000000000001
100000000000000000000000000000100000100000000000000000000000000000000000000000000000000000000000000001
100000000000000000000000000000100000100000000000000000000000000000000000000000000000000000000000000001
100000000000000000000000000000100111100000000000000000000001111111111111111111111111111111111111110001
100000000000000000000000000000100110000000000000000000000001                                     10001
100000000000000000000000000000100100000000000000000000000001                                     10001
100000000000000000000000000000100100000000000000000000000001111111111111111111111111111111111111110001
100000000000000000000000000000100100000000000000000000000000000000000000000000000000000000000000000001
100000000000000000000000000000010100000000000000000000000000000000000000000000000000000000000000000001
100000000000000000000000000000000100000000000000000000000000000000000000000000000000000000000000000001
100000000000000000000000000000000000000000000000000000000001111111111111111111111111111111111111111111
100000000000000000000000000000000000000000000000000000000001
100000000000000000000000000000000000000000000000000000000001
100000000000000000000000000000000000000000000000000000000001
100000000000000000000000000000000000000000000000000000000001
100000000000000000000000000000000000000000000000000000000001
111111111111111111111111111111111111111111111111111111111111