NO ./textures/wall.png

SO ./textures/wall.png

WE ./textures/wall1.png

EA ./textures/wall1.png

F 68,68,68

C 135,206,235

111111111111111111111111111111111111111111111111111111111111
100000000000000000000000000000000000000000000000000000000001
100000000000000000000000000000000000000000000000000000000001
100000000000000000000000000000000000000000000000000000000001
10000000E000000100000000000010000000000000100000000000001001
100000000000001010000000000101000000000001010000000000010101
100000000000010001000000001000100000000010001000000000100011
100000000000100000100000010000010000000100000100000001000001
100000000000010001000000001000100000000010001000000000100011
100000000000001010000000000101000000000001010000000000010101
100000000000000100000000000010000000000000100000000000001001
100000010000000000000100000000000000100000000000000010000001
100000101000000000001010000000000001010000000000000101000001
100001000100000000010001000000000010001000000000001000100001
100010000010000000100000100000000100000100000000010000010001
100001000100000000010001000000000010001000000000001000100001
100000101000000000001010000000000001010000000000000101000001
100000010000000000000100000000000000100000000000000010000001
100000000000000000000000000000000000000000000000000000000001
100000000000000000000000000000000000000000000000000000000001
111111111111111111111111111111111111111111111111111111111111