NO ./textures/wall.png

SO ./textures/wall.png

WE ./textures/wall1.png

EA ./textures/wall1.png

F 40,40,40

C 180,0,0

111111111111111111111111111111111
100000000000000000100000000000001
100000000000000000100000000000001
100000000000000000111000000000001
1000E0000000000000DDD000000000001
100000000000000000111000000000001
100000000000000000100000000000001
100000000000000000100000000000001
111111111111111111111111111111111