NO ./textures/wall1.png

SO ./textures/wall2.png

WE ./textures/wall3.png

EA ./textures/wall4.png

F 70,50,40

C 80,0,15

    1111111111111111111111111111111111111111111111111111111111111111111111111111111
  110000000000000000000000000000000000000000000000000000000000000000000000000000011
11000000000000000000000000000000000000000000000000000000000000000000000000000000011
10000000111111111111111111111D11D11D1111111D111111111D1111111D111111111110111110011
10000011                    10011100000000000000000000000000001         10001110011
100011                       100000111001101011100011111110001           1100000011
100011   111111111111     111111111   11  1 1   111       111   111111111  11110011
1000D01   1          1   1         1  1 1  1 1   1 1     1 1   1         1  1110011
10001001   11111  11111  1  11111  1  1 1 1 1     1 1   1 1    1  11111  1   110011
100011001      1 1       1 1     1 1  1 11 1       1 1 1 1     1 1     1 1   110011
1000111001     1 1       1 1     1 1  1   1         1 1 1      1 1     1 1   110011
100011 1001    1 1       1 1     1 1  1   1          1 1       1 1     1 1   110011
100011  1001   1 1       1 1     1 1  1 11 1         1 1       1 1     1 1   110011
100011   101   1 1       1  11111  1  1 1 1 1     1  1 1   1   1  11111  1   110011
100011  1001   1 1       1         1  1 1  1 1   101 1 1  101  1         1   110011
100011 10001    11        111111111   11    1   10001 11 10001  111111111    11D111
1000111001001     1      100001            11111000001101000001              110011
100011001 1D1  1 101    1000001111111111111000000111000000000001           11000011
100011D1111001101000111100000100000000000000111111111110000000001111111111100000011
10000000000000000000000000000000000000000000000000000000000000000000000000000000011
100000000000000000000000000000000000000000000000000000000000000000000000000000011
1111111111D10111111111111111111111110001111111111111111111111111111111111111111
      1100011                     111D111
    1100011111111111111111111111111100011
  110000000000000000000000000000000000011
11000100100000000000000000000000000001011
10010001101111111111111101101101111110011
100011000011           100101001   110111
11001111001             1000001    110011
1100111001      111      11111111  111011
110011001     111      111    111  110011
10000001    111 111         111    110111
1010111   111  111       111    111000011
101011  11111111111   111      1000011011
10101111     111    111       10011110011
101000001   111   11111111    101  110111
1000001001                  11001  110011
100011 101                 10001111001011
10001111011111111111111111100111100010011
10000000000000100000111111110000110100011
100001111110000001100000000000000000011
11111111111D1111111111111111111111111
  1 1     101
   1     1001
  101   1001
110011 1001
 11S011001
  1000001
   10111
    1