NO ./textures/wall1.png

SO ./textures/wall2.png

WE ./textures/wall3.png

EA ./textures/wall4.png

F 18,18,23

C 40,0,10

      11111111111111111111111111111111111111111111111111111111111111111111111111
     1110000001111110000000000000000011000111111111000000000000000000000000111011
    110000111000000000111000011101000000100000000000001111111110001110001100000011
   11000111111111111111111111111111111111111111111111111111111111111111111111110011
  100011                                                                      110011
 11D111  111111111111     111111111   11    11  111       111   111111111      11D111
110011    1          1   1         1  1 1  1 1   1 1     1 1   1         1      100111
110111     11111  11111  1  11111  1  1 1 1 1     1 1   1 1    1  11111  1      110011
110111         1 1       1 1     1 1  1 11 1       1 1 1 1     1 1     1 1      111011
110111         1 1       1 1     1 1  1   1         1 1 1      1 1     1 1      111011
110111         1 1       1 1     1 1  1   1          1 1       1 1     1 1      111011
110011         1 1       1 1     1 1  1 11 1         1 1       1 1     1 1      110011
111011         1 1       1  11111  1  1 1 1 1        1 1       1  11111  1      110111
110011         1 1       1         1  1 1  1 1       1 1       1         1      100011
 11D111         11        111111111   11    11        11        111111111      11D111
  100011                                                                      110011
   11000111111111111111111111111111111111111111111111111111111111111111111111110011
    110001000000000000000000000000001111110000000001111110100000000000111001110011
    10010001110000000000000110111000000000000111000000000000111011100000000000011
   10011111111111111111111111111111111111111111111111111111111111111111111111111
  1001
111D111
1000001
1000001
100N001
1000001
1000001
1111111