 NO ./path_to_the_north_texture                            
WE          ./path_to_the_south_texture
SO ./path_to_the_west_texture  
EA ./path_to_the_east_texture

F 255,9,55
C 0,0,100 

111111111111111111111111111111111111111
10000000000000100000000000000000000001
10000000000000100000000000000000000001
11111111111100000000000000000000000001
11111111110000000000000000000000001111
10000000000000000000000000000000000001
10000000W0000000000000000000000000001
11111111111111111000000001111111111111111111
10000000000000000000000000000000000000000001
100000000000000000000000000000000000000000001
11111111111111111111111111111111111111111111
11111111111111        11111111111111111111111



               
 
